ajac	ajca
ajaca	ajca
ajaka	ajka
alac	alca
alaca	alca
alan	alni
anaka	anki
anjac	anjca
antan	antni
aoca	alca
atak	atka
ataka	atka
atan	atni
atci	atka
atcima	atka
avilan	avilni
ačak	ačka
ačaka	ačka
ašan	ašni
baci	baci
bilan	bilni
bojci	bojka
cenata	centa
centar	centra
centara	centra
daba	dba
denata	denta
dušan	dušni
ejac	ejca
ejaca	ejca
ekat	ekta
ekata	ekta
elac	elca
elaca	elca
esama	esma
eskan	eskna
etak	etka
etaka	etka
genata	genta
gilan	gilni
ijeran	ijerni
ijesan	ijesni
inzi	ing
inzima	ing
istar	istra
istara	istra
itak	itka
itaka	itka
itci	itka
izam	izma
izama	izma
jaci	jak
jacima	jak
jebe	jebi
jenata	jenta
kusan	kusni
kuse	kusi
kustava	kustva
lanata	lanta
laran	larni
lenata	lenta
ljac	ljca
ljaca	ljca
lozi	loga
lozima	loga
mac	mca
maca	mca
manata	manta
menata	menta
metara	metra
nac	nca
nac	nca
naca	nca
naca	nca
nicima	nik
nilan	nilni
njac	njca
njaca	njca
nstava	nstva
ojac	ojca
ojaca	ojca
ojaka	ojka
ojsci	ojska
olac	olca
olaca	olca
olce	olca
otak	otka
otaka	otka
ozan	ozni
ošću	osti
pjesi	pjeh
pjesima	pjeh
pletan	pletni
pravan	pravni
rac	rca
raca	rca
rave	ravi
rilan	rilni
sac	sca
saca	sca
sanata	santa
silan	silni
sivan	sivni
snici	snik
stavan	stavni
tanata	tanta
tetan	tetni
tetici	tetika
teticima	tetika
ticima	tik
tilan	tilni
tivan	tivni
tičan	tični
tvenici	tvenik
utak	utka
utaka	utka
utci	utka
utcima	utka
ušak	uška
vac	vca
vaca	vca
venata	venta
vojci	vojka
voljan	voljni
zicima	zik
čajan	čajni
čci	čka
čcima	čka
šac	šca
šaca	šca
šave	šavi
